NO textures/matrix.xpm
SO textures/matrix.xpm
WE textures/matrix.xpm
EA textures/matrix.xpm

F 0,0,0
C 0,0,0













len = 20
index = 19



         11111111111111111111
        1111000111111111111101
        100000000000000000000011           
     111111111000000000001
11101010101111111000111111
1 100010100010000000001
111110101111101011101
100000101000101000001
101111101011101111111
101000001010100000101
101011111010111110101
101010001010100010101
101110101010101010101
100000101010001010001
111111101011111011101
100000101000100010001
101110101110101110111
101000100000100010101
101011111111111010101
100010000000000010001
101010111011111111101
1N0000000000000000001
111111111111111111111