 
SO src/north.xpm
WE src/north.xpm 
EA src/north.xpm

F    225,0,0
C    200,200,200

11111
10001
10S01      111111
10001
10001
10001
11001
10001
10001
10001
10001
10001
11111
