111111111111111
100000000C0P0E1
111111111111111
